5 4 4 3 3 2 2 5 5 4 4 3 3 2 2	 
5 4 4 3 3 1 1 5 1 1 4 3 3 2 2	
5 4 4 3 1 1 1 1 1 1 1 3 3 2 2
5 4 4 3 1 1 1 1 1 1 1 3 3 2 2
5 4 4 3 3 1 1 1 1 1 4 3 3 2 2
5 4 4 3 3 2 1 1 1 4 4 3 3 2 2
5 4 4 3 3 2 2 1 5 4 4 3 3 2 2 
5 4 4 3 3 2 2 5 5 4 4 3 3 2 2
